0xDC00000E
0x00000000
0x00000000
0x00000000
0x00000000
0x00000000
0x00000000
0x00000000
0x60620000
0x5C030000
0xB8000003
0x6C610000
0x48420001
0xDFFFFFFA
0x7C000000
0x03C07FFC
0x6820001B
0x00400050
0xE7FFFFF5
0xFC000000
0x0A48656C
0x6C6F2077
0x6F726C64
0x2066726F
0x6D20506F
0x78696D21
0x0A000000
0x8888888B
